##a#########
#   #w   # #
#   #  # # #
###### #   #
#  w   #   #
#    w # #z#
#  w#  # ###
#   #### # #
#      # # #
#w  #      #
############
